15
20
DDDSSSSSLLLMMLLLLSSS
DDDDSSSSSLLLMLLSSSSS
DDDDDDDSSSLLLLSSSSDD
DDDDDDDDSSSSLSSSDDDD
DDDDDDDDDDSSSSDDDDDD
DDDDDDDDDDDDSDDDDDDD
DDDDDDDDDDDDDDDDDDDD
DDDDDDDDDDDDDDDDDDDD
SSSSDDDDDDDDDDDDDDDD
SSSSSSSDDDDDDDDDDDDD
LSSSSSSSSDDDDDDDDDDD
LLLSSSSSSSDDDDDDDDDD
MLLLLSSSSSSDDDDDDDDD
MMMLLLLSSSDDDDDDDDDD
MMLLLSSSSDDDDDDDDDDD